#####################
#                   #
#            [=]    #
#                   #
#  []               #
#                   #
############=########
#        e #     e  #
#   ########    #   #
#     ##            #
#    #    @       ###
#                #  #
#               # # #
#    #        #     #
#           #  e    #
#     #           B #
#     #             #
#      #       e    #
#   e   ##          #
#          #        #
#####################
